###########
#T.......T#
#.#.......#
#.#.......#
#.###.###.#
#.......#.#
#.......#.#
#.......#.#
#T.......T#
###########