###########
#TTTTTTTTT#
#.........#
#.........#
#.........#
#.........#
##.......##
###.....###
####...####
###########